Casual,Date,Member,Total_rides,apparent_temperature_mean (°C),temperature_2m_mean (°C),weathercode (wmo code),windspeed_10m_max (km/h)
371,2021-01-01,590,961,-0.9,2.3,63,10.6
2874,2021-01-02,2844,5718,4.8,7.6,61,19.1
495,2021-01-03,1133,1628,0.9,3.9,63,13.0
907,2021-01-04,2074,2981,1.0,4.1,3,13.3
1057,2021-01-05,2004,3061,1.4,4.0,51,9.2
1359,2021-01-06,1753,3112,-1.1,3.4,3,20.8
1167,2021-01-07,2143,3310,-1.3,2.9,3,14.4
784,2021-01-08,2203,2987,-3.1,0.7,3,12.9
1490,2021-01-09,2582,4072,-3.8,1.7,2,19.4
1479,2021-01-10,2522,4001,-1.8,2.6,1,18.7
677,2021-01-11,2194,2871,-1.8,1.5,3,9.8
919,2021-01-12,2725,3644,-2.2,1.3,0,10.2
1095,2021-01-13,2788,3883,-1.3,2.1,0,9.7
1095,2021-01-14,2702,3797,0.3,3.5,2,9.2
924,2021-01-15,2410,3334,1.0,4.4,53,18.9
1850,2021-01-16,2841,4691,0.6,4.3,53,16.2
1437,2021-01-17,2308,3745,-1.0,3.4,3,19.6
1229,2021-01-18,2212,3441,-1.9,2.6,2,20.8
1185,2021-01-19,2185,3370,-2.1,2.3,3,20.5
995,2021-01-20,1627,2622,-3.3,1.4,53,24.7
1106,2021-01-21,2423,3529,-1.7,2.3,1,12.3
1302,2021-01-22,2734,4036,-1.6,2.8,3,20.4
1145,2021-01-23,2337,3482,-5.9,-0.3,3,23.6
1143,2021-01-24,2166,3309,-5.4,-0.9,3,14.0
543,2021-01-25,1847,2390,-2.1,1.5,73,10.0
492,2021-01-26,1505,1997,-1.4,1.5,73,11.9
968,2021-01-27,2560,3528,-1.1,2.8,3,17.2
683,2021-01-28,1984,2667,-6.2,-0.1,71,27.6
824,2021-01-29,2046,2870,-8.5,-1.9,3,27.2
1463,2021-01-30,2535,3998,-6.0,-1.4,3,14.2
329,2021-01-31,706,1035,-4.8,-0.5,75,17.9
227,2021-02-01,746,973,-4.9,-0.1,73,18.9
382,2021-02-02,1069,1451,-5.1,0.5,71,23.7
684,2021-02-03,1792,2476,-5.0,0.9,3,26.3
863,2021-02-04,2311,3174,-4.5,0.3,3,20.8
1400,2021-02-05,2849,4249,0.9,5.3,55,18.6
2149,2021-02-06,3263,5412,-1.3,3.0,3,22.3
757,2021-02-07,1532,2289,-1.6,2.1,75,17.4
844,2021-02-08,2048,2892,-8.5,-3.9,1,11.4
920,2021-02-09,2642,3562,-0.6,2.8,3,11.4
569,2021-02-10,1793,2362,-1.9,1.6,75,10.8
566,2021-02-11,1675,2241,-2.8,0.7,75,12.0
828,2021-02-12,2201,3029,-5.9,-1.8,71,11.0
236,2021-02-13,649,885,-6.2,-1.9,73,12.5
829,2021-02-14,1535,2364,-3.5,0.0,3,8.7
777,2021-02-15,1943,2720,-1.9,1.4,53,13.7
722,2021-02-16,2127,2849,-0.0,3.7,63,23.5
557,2021-02-17,1392,1949,-6.8,-1.9,1,20.5
217,2021-02-18,527,744,-5.9,-1.7,75,15.1
524,2021-02-19,1521,2045,-4.0,0.0,73,15.5
796,2021-02-20,1849,2645,-8.3,-2.5,3,23.4
919,2021-02-21,2053,2972,-7.1,-2.8,2,15.9
334,2021-02-22,1214,1548,-3.5,0.7,73,16.2
957,2021-02-23,2363,3320,-0.1,4.2,51,25.8
1733,2021-02-24,3449,5182,4.2,8.1,1,20.4
1290,2021-02-25,2891,4181,3.5,7.5,1,21.4
1230,2021-02-26,2543,3773,0.9,4.7,71,12.8
2130,2021-02-27,2949,5079,4.3,6.6,73,12.5
371,2021-02-28,768,1139,4.6,6.7,63,15.5
753,2021-03-01,1750,2503,5.2,8.4,63,27.8
1014,2021-03-02,2459,3473,-2.7,2.3,0,20.6
1615,2021-03-03,3256,4871,1.3,5.2,0,12.6
1107,2021-03-04,2709,3816,1.2,6.1,3,24.2
1048,2021-03-05,2586,3634,-4.3,1.6,2,27.8
2323,2021-03-06,2869,5192,-3.0,2.1,3,21.2
1835,2021-03-07,2456,4291,-2.6,1.5,0,13.8
1183,2021-03-08,2580,3763,-0.6,3.2,1,10.7
2067,2021-03-09,3397,5464,6.7,9.8,1,14.0
2389,2021-03-10,3875,6264,8.5,10.9,1,13.0
2913,2021-03-11,4166,7079,12.7,15.4,2,17.4
2712,2021-03-12,3703,6415,13.6,15.9,3,15.5
4497,2021-03-13,3758,8255,5.2,9.5,1,20.8
3640,2021-03-14,3292,6932,3.8,9.0,1,30.0
1249,2021-03-15,2394,3643,-0.6,4.1,3,21.1
1029,2021-03-16,2430,3459,1.4,5.0,51,14.1
1610,2021-03-17,3019,4629,5.4,7.5,3,8.8
558,2021-03-18,1445,2003,7.0,8.9,63,18.9
1773,2021-03-19,3018,4791,1.4,6.4,53,22.2
4379,2021-03-20,3875,8254,1.7,5.2,0,12.1
4180,2021-03-21,3909,8089,5.0,8.0,0,10.0
2219,2021-03-22,3229,5448,5.9,8.5,0,10.5
2229,2021-03-23,3606,5835,8.8,11.0,3,12.8
522,2021-03-24,1465,1987,12.2,12.7,63,13.1
1894,2021-03-25,3470,5364,15.7,15.5,51,11.3
3982,2021-03-26,4585,8567,18.2,20.0,53,28.2
8232,2021-03-27,5106,13338,13.3,15.0,2,14.1
2028,2021-03-28,2071,4099,13.9,15.5,63,28.5
2994,2021-03-29,3785,6779,5.5,9.8,2,30.6
4805,2021-03-30,4746,9551,8.5,11.4,1,18.3
1138,2021-03-31,2239,3377,14.4,14.8,63,17.9
1824,2021-04-01,2670,4494,2.5,7.2,53,26.4
2539,2021-04-02,2904,5443,-2.5,3.4,3,24.3
7206,2021-04-03,3743,10949,1.3,5.2,0,12.8
7441,2021-04-04,4050,11491,8.2,11.4,2,19.3
3835,2021-04-05,3833,7668,10.8,13.2,3,13.7
3530,2021-04-06,4407,7937,13.8,15.2,51,12.2
3461,2021-04-07,4436,7897,16.5,17.0,2,12.0
3358,2021-04-08,4433,7791,12.7,15.0,51,17.8
2323,2021-04-09,3508,5831,12.3,13.5,61,15.6
6719,2021-04-10,4710,11429,15.5,15.6,3,12.0
5368,2021-04-11,4288,9656,18.6,18.9,61,17.6
1794,2021-04-12,3286,5080,13.8,14.8,51,14.4
2300,2021-04-13,4126,6426,12.0,13.2,51,10.1
932,2021-04-14,2183,3115,12.7,13.2,55,11.2
2683,2021-04-15,4328,7011,11.3,13.6,53,21.7
2443,2021-04-16,3931,6374,6.1,10.3,51,25.4
4909,2021-04-17,4517,9426,7.7,10.4,3,14.3
4727,2021-04-18,4209,8936,9.6,11.6,2,11.0
2070,2021-04-19,3462,5532,10.4,12.1,3,9.8
3157,2021-04-20,4815,7972,13.2,15.3,1,17.7
1643,2021-04-21,3429,5072,8.9,13.1,51,29.6
1535,2021-04-22,3125,4660,1.5,6.9,2,26.1
3024,2021-04-23,4388,7412,6.4,9.6,3,16.3
3672,2021-04-24,4087,7759,9.1,11.4,61,11.5
3365,2021-04-25,3680,7045,10.8,13.2,63,20.7
2283,2021-04-26,3945,6228,8.7,11.9,1,16.3
3065,2021-04-27,4798,7863,17.0,17.8,1,16.8
2712,2021-04-28,4554,7266,23.7,23.2,1,17.4
2346,2021-04-29,4302,6648,23.8,22.7,53,20.4
2475,2021-04-30,3877,6352,12.7,16.8,51,36.7
5551,2021-05-01,4988,10539,8.7,12.8,1,27.0
4989,2021-05-02,4734,9723,17.1,19.3,1,18.7
1952,2021-05-03,3552,5504,20.3,19.9,61,18.6
2144,2021-05-04,3755,5899,24.7,23.0,53,15.5
2244,2021-05-05,4265,6509,20.3,20.0,63,23.7
3082,2021-05-06,4862,7944,11.2,13.8,3,18.9
2159,2021-05-07,3470,5629,11.4,12.7,63,11.9
4228,2021-05-08,4271,8499,8.1,10.7,53,22.8
3448,2021-05-09,3818,7266,10.7,12.9,51,17.2
2693,2021-05-10,4316,7009,12.8,15.2,53,22.1
2752,2021-05-11,4898,7650,11.6,14.1,3,19.4
2933,2021-05-12,4862,7795,10.4,13.1,3,15.6
3494,2021-05-13,5100,8594,12.1,14.3,1,11.1
3984,2021-05-14,5230,9214,13.7,15.2,1,8.9
7273,2021-05-15,5703,12976,15.2,16.6,2,10.4
4458,2021-05-16,4312,8770,14.0,15.2,53,11.8
3254,2021-05-17,4800,8054,16.7,17.2,3,7.9
3404,2021-05-18,5405,8809,18.3,18.8,2,12.0
3541,2021-05-19,5463,9004,21.4,21.4,1,11.1
3512,2021-05-20,5236,8748,22.3,22.8,2,14.8
4739,2021-05-21,5640,10379,21.2,21.3,1,9.4
6750,2021-05-22,5663,12413,23.7,24.3,2,15.5
5314,2021-05-23,4757,10071,26.9,26.8,2,18.6
1486,2021-05-24,2515,4001,20.5,20.2,53,13.6
3373,2021-05-25,5317,8690,20.6,20.0,3,11.3
2584,2021-05-26,4419,7003,28.6,26.5,51,11.8
3595,2021-05-27,5220,8815,25.8,24.9,1,13.0
2977,2021-05-28,3822,6799,22.3,21.8,63,16.8
1574,2021-05-29,2003,3577,10.8,12.5,63,18.2
4061,2021-05-30,2994,7055,9.0,11.1,61,17.0
6482,2021-05-31,4757,11239,15.3,16.0,2,13.9
3145,2021-06-01,4816,7961,18.8,18.8,3,11.3
3289,2021-06-02,5152,8441,20.9,20.5,3,15.5
2774,2021-06-03,4310,7084,24.2,22.1,63,14.3
4061,2021-06-04,5393,9454,26.4,23.5,61,14.0
6287,2021-06-05,5458,11745,26.4,24.9,1,11.9
4469,2021-06-06,4593,9062,28.7,26.5,1,11.6
2852,2021-06-07,4687,7539,31.0,27.3,63,11.9
2905,2021-06-08,5063,7968,31.2,26.7,63,10.0
3142,2021-06-09,5152,8294,29.7,25.3,61,7.7
2002,2021-06-10,3449,5451,29.0,24.8,63,14.4
1552,2021-06-11,2729,4281,21.9,20.3,63,19.8
6967,2021-06-12,6092,13059,22.3,20.5,51,13.0
5627,2021-06-13,4644,10271,24.7,22.6,51,11.3
3534,2021-06-14,4800,8334,27.0,24.3,61,10.2
3924,2021-06-15,5589,9513,23.1,22.2,53,13.6
4008,2021-06-16,5922,9930,20.7,21.4,1,13.6
4396,2021-06-17,5905,10301,19.5,20.4,2,13.1
5873,2021-06-18,5905,11778,22.3,22.4,2,12.8
6754,2021-06-19,5411,12165,27.5,25.2,63,15.0
5469,2021-06-20,4730,10199,30.1,26.6,51,10.8
2934,2021-06-21,4502,7436,31.5,27.4,53,12.1
2331,2021-06-22,4255,6586,23.0,21.2,61,17.1
4429,2021-06-23,6343,10772,18.3,18.9,2,10.7
4493,2021-06-24,6153,10646,20.6,20.4,3,11.3
5024,2021-06-25,5553,10577,22.6,21.5,2,12.0
6646,2021-06-26,5271,11917,27.6,24.7,53,18.3
5160,2021-06-27,4661,9821,30.0,26.8,51,14.5
3393,2021-06-28,4821,8214,31.5,28.2,51,13.8
3222,2021-06-29,5304,8526,32.7,29.3,1,11.9
3102,2021-06-30,4953,8055,32.9,30.0,51,14.3
2780,2021-07-01,4450,7230,30.8,26.3,65,12.1
4794,2021-07-02,5293,10087,24.5,23.0,63,14.5
7847,2021-07-03,5296,13143,21.4,21.4,51,14.6
11815,2021-07-04,5068,16883,24.3,22.8,2,10.2
6643,2021-07-05,4618,11261,28.2,25.8,2,11.6
3671,2021-07-06,5098,8769,31.3,27.9,1,13.1
3336,2021-07-07,5410,8746,32.8,28.6,61,11.9
2633,2021-07-08,4455,7088,29.6,26.2,63,17.4
3649,2021-07-09,4818,8467,28.9,25.5,65,18.9
7498,2021-07-10,5981,13479,26.4,24.7,3,14.2
5668,2021-07-11,5036,10704,29.6,25.9,61,16.2
3513,2021-07-12,5145,8658,33.1,28.4,53,14.2
3488,2021-07-13,5642,9130,32.9,29.1,2,17.2
3428,2021-07-14,5527,8955,31.2,27.6,63,13.3
4178,2021-07-15,5799,9977,31.4,27.1,51,10.0
4723,2021-07-16,5666,10389,32.6,28.7,1,10.3
6108,2021-07-17,5033,11141,33.0,28.2,63,13.4
6297,2021-07-18,5117,11414,27.3,25.5,3,19.3
3804,2021-07-19,5352,9156,27.9,25.9,2,10.5
3663,2021-07-20,5877,9540,30.0,26.9,1,9.0
3826,2021-07-21,5720,9546,29.2,27.1,53,13.6
4060,2021-07-22,5854,9914,24.8,24.3,1,11.9
4847,2021-07-23,5772,10619,24.8,24.0,2,8.3
6440,2021-07-24,5177,11617,26.8,25.1,51,14.6
5212,2021-07-25,4660,9872,30.4,28.0,51,15.6
2860,2021-07-26,4771,7631,32.2,28.5,51,9.2
3210,2021-07-27,5443,8653,32.6,28.4,1,5.7
3334,2021-07-28,5645,8979,30.1,28.1,1,12.1
3537,2021-07-29,5409,8946,31.5,28.1,51,10.5
4393,2021-07-30,5687,10080,29.2,27.9,51,15.0
6902,2021-07-31,5450,12352,25.0,24.5,3,12.1
3593,2021-08-01,3584,7177,26.6,23.7,61,10.5
4055,2021-08-02,5455,9510,23.6,22.8,2,13.4
3985,2021-08-03,5864,9849,24.4,23.1,2,10.0
4183,2021-08-04,5815,9998,23.6,22.5,3,15.0
4294,2021-08-05,5870,10164,26.1,24.3,2,7.0
4587,2021-08-06,5461,10048,27.6,26.0,2,13.8
4247,2021-08-07,3885,8132,25.0,22.7,53,9.0
6262,2021-08-08,4735,10997,27.4,24.8,1,11.4
3201,2021-08-09,4619,7820,30.1,26.0,63,13.5
2553,2021-08-10,4393,6946,32.3,28.1,53,12.9
2647,2021-08-11,4687,7334,34.1,28.9,61,8.6
3481,2021-08-12,4959,8440,34.5,30.1,1,12.2
2963,2021-08-13,4097,7060,34.7,29.6,63,10.7
5319,2021-08-14,4819,10138,32.2,27.2,63,10.2
5022,2021-08-15,4487,9509,27.1,24.2,63,12.2
2006,2021-08-16,3291,5297,28.2,24.1,61,8.5
3080,2021-08-17,4982,8062,30.4,25.7,53,10.5
2995,2021-08-18,5211,8206,30.7,26.2,61,17.8
3423,2021-08-19,5142,8565,31.2,27.3,51,11.9
3248,2021-08-20,4114,7362,28.7,24.5,63,9.9
5240,2021-08-21,5102,10342,29.3,24.7,63,7.7
4921,2021-08-22,4694,9615,28.8,24.5,51,9.4
3268,2021-08-23,5258,8526,30.8,26.8,53,11.6
3122,2021-08-24,5834,8956,32.3,28.2,1,11.7
2873,2021-08-25,5712,8585,33.8,28.4,51,8.3
2810,2021-08-26,5205,8015,33.6,27.6,63,9.2
3245,2021-08-27,5222,8467,33.4,27.5,63,8.6
5928,2021-08-28,5818,11746,31.8,26.6,51,12.4
4526,2021-08-29,5063,9589,29.4,25.3,3,11.0
2821,2021-08-30,5727,8548,31.4,26.3,61,9.6
2727,2021-08-31,6264,8991,29.9,25.2,53,8.9
1416,2021-09-01,3861,5277,26.5,23.3,63,27.5
3975,2021-09-02,6994,10969,20.1,21.1,1,21.1
4932,2021-09-03,6765,11697,19.8,20.0,3,13.1
7225,2021-09-04,5422,12647,22.2,21.0,2,11.0
5864,2021-09-05,4247,10111,24.2,22.2,61,11.2
5935,2021-09-06,5338,11273,25.5,23.9,55,16.7
3334,2021-09-07,6269,9603,24.8,23.6,1,12.6
3221,2021-09-08,6713,9934,26.9,24.8,51,14.7
3174,2021-09-09,6574,9748,23.9,21.9,61,13.0
4517,2021-09-10,7150,11667,19.3,20.1,2,18.4
6455,2021-09-11,6589,13044,20.2,20.1,3,13.3
5408,2021-09-12,5859,11267,24.8,24.0,1,15.1
2994,2021-09-13,6154,9148,28.8,26.0,2,13.7
3145,2021-09-14,6732,9877,29.9,26.2,51,11.7
3254,2021-09-15,6914,10168,29.0,26.7,51,16.9
2061,2021-09-16,4371,6432,27.7,24.1,63,9.7
3849,2021-09-17,6201,10050,27.3,23.6,55,10.7
6077,2021-09-18,6509,12586,28.4,24.3,51,5.6
5513,2021-09-19,5883,11396,24.9,23.4,3,10.7
3324,2021-09-20,6519,9843,21.7,21.0,2,13.1
3136,2021-09-21,7114,10250,23.7,22.4,51,14.0
1498,2021-09-22,4634,6132,25.5,23.0,63,23.1
2715,2021-09-23,5826,8541,22.0,21.3,63,21.1
4529,2021-09-24,7369,11898,17.8,18.5,3,11.0
7046,2021-09-25,6768,13814,19.0,18.8,1,7.9
5571,2021-09-26,6008,11579,17.2,18.5,0,16.5
2940,2021-09-27,6632,9572,18.5,19.5,1,15.3
2812,2021-09-28,6790,9602,21.6,21.0,61,15.5
3294,2021-09-29,7140,10434,17.6,18.1,1,12.0
3455,2021-09-30,7183,10638,16.4,17.3,3,10.9
4688,2021-10-01,7144,11832,16.3,16.6,3,7.6
7475,2021-10-02,7046,14521,19.4,18.7,1,8.7
5970,2021-10-03,6065,12035,23.6,22.0,3,12.5
3039,2021-10-04,6087,9126,25.1,22.9,63,11.8
2875,2021-10-05,6451,9326,23.6,20.9,61,13.6
2750,2021-10-06,6412,9162,22.4,20.3,51,12.1
3560,2021-10-07,7146,10706,22.3,20.6,3,8.3
4638,2021-10-08,6551,11189,22.5,20.6,3,7.0
7010,2021-10-09,6047,13057,20.6,20.2,3,16.2
5471,2021-10-10,5004,10475,20.9,20.2,51,16.4
3815,2021-10-11,5611,9426,20.2,19.7,3,12.4
2819,2021-10-12,6026,8845,21.3,19.7,51,7.8
3493,2021-10-13,7249,10742,22.7,20.3,51,6.1
4099,2021-10-14,7366,11465,22.7,21.4,3,10.4
5402,2021-10-15,7027,12429,23.6,22.0,3,11.3
4855,2021-10-16,4903,9758,19.9,20.0,63,21.4
4995,2021-10-17,5415,10410,11.0,14.6,3,24.6
3071,2021-10-18,6198,9269,10.7,14.1,1,23.6
3408,2021-10-19,7111,10519,12.2,14.6,0,14.5
3491,2021-10-20,7253,10744,15.8,17.6,1,13.2
4136,2021-10-21,7359,11495,16.8,17.7,1,19.9
5212,2021-10-22,6971,12183,16.8,18.2,3,19.2
6501,2021-10-23,6126,12627,14.0,15.4,3,15.0
5265,2021-10-24,5559,10824,14.5,15.7,3,13.6
2325,2021-10-25,5240,7565,19.9,19.7,63,16.5
2148,2021-10-26,7168,9316,12.8,15.2,63,30.4
2717,2021-10-27,8561,11278,12.5,15.2,3,31.8
2859,2021-10-28,8312,11171,13.6,14.7,3,14.7
939,2021-10-29,2747,3686,13.6,15.0,63,29.6
4584,2021-10-30,7570,12154,14.3,15.0,53,14.4
4093,2021-10-31,6872,10965,12.6,14.3,51,19.7
2470,2021-11-01,6908,9378,9.6,12.1,2,16.8
1161,2021-11-02,4995,6156,6.3,8.2,53,10.0
1952,2021-11-03,7079,9031,3.4,6.8,1,14.5
2150,2021-11-04,6985,9135,3.8,6.7,2,7.6
2923,2021-11-05,6737,9660,3.0,6.3,1,11.8
4118,2021-11-06,6894,11012,3.8,6.9,3,12.0
3194,2021-11-07,6520,9714,5.1,8.3,1,12.4
2163,2021-11-08,7126,9289,8.7,11.5,0,14.0
2561,2021-11-09,7979,10540,11.0,12.8,0,9.7
2714,2021-11-10,8577,11291,12.5,14.1,3,12.0
3413,2021-11-11,8134,11547,12.7,14.2,2,16.8
3397,2021-11-12,6710,10107,13.5,15.0,63,20.5
4025,2021-11-13,6233,10258,5.0,8.6,51,28.6
2476,2021-11-14,5119,7595,2.0,5.9,3,15.3
1514,2021-11-15,5505,7019,2.1,6.7,51,28.5
1774,2021-11-16,6705,8479,2.9,6.0,2,9.5
2119,2021-11-17,7386,9505,7.5,9.6,2,14.1
2394,2021-11-18,7094,9488,12.3,14.6,55,20.9
1855,2021-11-19,5973,7828,1.0,6.1,51,21.8
2589,2021-11-20,5412,8001,0.5,3.8,2,10.0
2407,2021-11-21,4664,7071,4.1,7.0,3,12.9
1776,2021-11-22,5021,6797,4.6,8.2,53,19.6
1536,2021-11-23,4520,6056,-2.2,3.0,2,20.8
1759,2021-11-24,3934,5693,-1.2,2.7,1,11.3
1904,2021-11-25,2359,4263,2.6,5.8,3,9.5
1446,2021-11-26,2373,3819,0.9,5.8,61,29.1
1719,2021-11-27,2958,4677,-2.2,2.7,2,19.2
2193,2021-11-28,3866,6059,3.6,6.8,2,9.0
1288,2021-11-29,4458,5746,-0.4,4.4,3,23.3
1468,2021-11-30,5375,6843,0.1,3.7,3,13.5
1883,2021-12-01,5904,7787,2.9,6.1,51,12.0
2518,2021-12-02,6381,8899,8.6,11.7,51,20.7
2549,2021-12-03,5958,8507,5.6,9.1,1,15.8
4155,2021-12-04,5943,10098,5.2,8.0,2,10.7
2649,2021-12-05,4411,7060,2.5,6.0,3,11.0
1866,2021-12-06,5310,7176,9.2,12.2,55,29.8
1540,2021-12-07,5022,6562,-1.0,3.4,2,23.8
1572,2021-12-08,4681,6253,-0.6,2.9,73,15.8
1710,2021-12-09,4899,6609,-2.0,1.9,3,13.5
2649,2021-12-10,5454,8103,3.0,6.0,51,13.6
3256,2021-12-11,4624,7880,11.8,14.0,63,27.7
2556,2021-12-12,4258,6814,1.3,6.2,3,29.7
1754,2021-12-13,4556,6310,0.6,4.2,1,9.9
2079,2021-12-14,5294,7373,2.1,5.7,1,11.5
1979,2021-12-15,5146,7125,4.2,6.7,2,9.8
2571,2021-12-16,5553,8124,8.5,11.8,1,20.0
2481,2021-12-17,5308,7789,10.4,13.1,3,19.6
2717,2021-12-18,4030,6747,7.9,10.1,61,12.3
1769,2021-12-19,3001,4770,3.0,7.2,51,23.5
1360,2021-12-20,3316,4676,-3.0,0.9,0,12.2
1210,2021-12-21,3061,4271,-1.9,1.5,51,8.5
1293,2021-12-22,2958,4251,-0.7,3.6,51,24.6
1189,2021-12-23,2471,3660,-3.5,0.8,2,13.8
1310,2021-12-24,2006,3316,3.4,7.2,3,18.3
1876,2021-12-25,1308,3184,10.4,12.7,61,17.5
2436,2021-12-26,2070,4506,8.3,11.1,3,16.7
1189,2021-12-27,1933,3122,0.8,3.9,53,13.1
2387,2021-12-28,2605,4992,5.1,7.9,51,14.3
1974,2021-12-29,2497,4471,8.0,9.8,61,11.3
2074,2021-12-30,2651,4725,8.2,9.1,61,8.3
2743,2021-12-31,2944,5687,10.7,11.7,53,13.0
1788,2022-01-01,1664,3452,14.4,14.1,63,13.7
2389,2022-01-02,3030,5419,13.6,14.6,61,20.0
174,2022-01-03,323,497,-4.4,0.5,75,22.3
369,2022-01-04,888,1257,-8.0,-3.8,3,12.0
610,2022-01-05,1655,2265,-3.1,1.0,3,15.8
1055,2022-01-06,2692,3747,-2.3,1.6,3,13.5
651,2022-01-07,1584,2235,-7.3,-1.9,75,22.7
1024,2022-01-08,2294,3318,-9.4,-4.8,0,14.4
462,2022-01-09,1302,1764,-2.2,2.0,61,17.1
1014,2022-01-10,2848,3862,-5.5,0.1,2,22.4
784,2022-01-11,2553,3337,-9.2,-3.9,3,20.5
1175,2022-01-12,3276,4451,-6.4,-1.5,1,16.4
1424,2022-01-13,3578,5002,-0.6,2.6,3,12.2
1505,2022-01-14,3504,5009,-0.7,3.4,3,18.4
1102,2022-01-15,2398,3500,-7.8,-2.3,3,17.4
412,2022-01-16,1201,1613,-8.3,-3.2,75,30.3
643,2022-01-17,1940,2583,-3.2,2.4,73,29.7
922,2022-01-18,3206,4128,-5.1,0.1,3,23.6
1271,2022-01-19,3902,5173,-1.5,3.0,3,18.3
845,2022-01-20,2444,3289,-1.8,2.1,73,15.7
881,2022-01-21,2778,3659,-9.3,-3.8,3,16.6
1345,2022-01-22,2804,4149,-8.6,-3.8,3,12.6
1294,2022-01-23,2674,3968,-5.4,-1.0,2,10.3
1061,2022-01-24,3377,4438,-3.8,0.4,3,15.6
1208,2022-01-25,3768,4976,-1.6,2.5,3,15.1
1054,2022-01-26,3223,4277,-7.1,-2.0,1,13.4
1067,2022-01-27,3534,4601,-6.3,-2.0,3,10.2
776,2022-01-28,2806,3582,-3.6,0.1,73,13.8
743,2022-01-29,1978,2721,-10.6,-4.0,71,26.0
859,2022-01-30,2220,3079,-9.1,-4.1,2,19.6
871,2022-01-31,3397,4268,-6.0,-1.7,3,11.1
1146,2022-02-01,4028,5174,-4.5,-0.6,1,10.9
1439,2022-02-02,4368,5807,-0.4,2.5,3,11.7
768,2022-02-03,2449,3217,5.5,7.7,63,21.6
637,2022-02-04,1904,2541,4.3,7.6,63,27.5
1315,2022-02-05,3126,4441,-6.8,-1.1,3,24.0
1236,2022-02-06,2970,4206,-6.1,-1.8,3,10.2
768,2022-02-07,3238,4006,-1.4,1.6,55,7.4
1220,2022-02-08,4281,5501,-2.0,2.1,1,16.7
1565,2022-02-09,4805,6370,0.2,3.9,0,14.6
1936,2022-02-10,4800,6736,3.1,7.1,53,25.1
2706,2022-02-11,5168,7874,4.8,8.7,0,21.4
3869,2022-02-12,4791,8660,7.1,10.8,3,21.1
871,2022-02-13,2040,2911,-2.8,1.3,73,14.0
860,2022-02-14,3223,4083,-7.5,-2.4,3,16.3
1242,2022-02-15,3788,5030,-5.4,-1.2,0,12.0
1569,2022-02-16,4614,6183,-0.9,3.2,3,16.2
1998,2022-02-17,5301,7299,9.7,13.3,55,23.9
1580,2022-02-18,3880,5460,3.8,8.6,61,32.4
1886,2022-02-19,3170,5056,-4.5,1.0,3,31.9
1968,2022-02-20,2887,4855,-4.7,-0.0,0,15.8
3509,2022-02-21,4457,7966,2.9,6.6,1,14.7
1366,2022-02-22,3773,5139,10.7,12.9,61,27.9
2591,2022-02-23,5477,8068,13.3,15.9,51,23.6
761,2022-02-24,2669,3430,-1.5,2.7,51,15.7
1697,2022-02-25,3956,5653,0.9,4.9,61,26.9
2562,2022-02-26,3744,6306,-1.4,2.7,3,15.3
2704,2022-02-27,3861,6565,0.6,4.9,1,19.8
1480,2022-02-28,4300,5780,-0.2,3.9,1,12.8
1882,2022-03-01,5046,6928,2.5,6.1,3,14.7
2506,2022-03-02,5382,7888,6.1,8.9,2,16.2
2075,2022-03-03,4980,7055,3.7,8.0,3,19.1
2194,2022-03-04,4523,6717,-1.8,2.2,1,15.5
4619,2022-03-05,5073,9692,4.0,7.1,2,15.9
4606,2022-03-06,4734,9340,15.0,16.5,55,23.5
2251,2022-03-07,4399,6650,17.1,19.0,55,30.0
2434,2022-03-08,5164,7598,4.3,8.6,3,26.4
993,2022-03-09,2898,3891,2.4,5.3,73,13.3
2382,2022-03-10,5195,7577,3.3,6.2,3,10.4
3757,2022-03-11,5480,9237,5.6,8.3,1,16.8
626,2022-03-12,1493,2119,-3.3,2.0,75,29.6
1610,2022-03-13,2701,4311,-6.9,-1.7,1,21.4
3095,2022-03-14,4912,8007,1.8,5.4,1,12.2
4339,2022-03-15,6081,10420,8.8,11.4,2,12.1
4641,2022-03-16,6414,11055,10.1,12.3,1,15.3
1755,2022-03-17,3848,5603,10.1,11.3,61,11.7
5417,2022-03-18,6028,11445,13.6,14.7,3,18.8
8072,2022-03-19,5956,14028,15.7,17.4,51,25.3
4630,2022-03-20,4371,9001,7.5,11.9,3,26.7
4813,2022-03-21,6216,11029,8.7,12.4,2,20.7
5460,2022-03-22,7282,12742,8.9,11.4,3,12.0
1745,2022-03-23,4160,5905,7.8,10.6,61,18.9
2775,2022-03-24,4956,7731,14.7,14.8,63,16.7
6259,2022-03-25,6409,12668,9.3,12.0,51,18.8
6536,2022-03-26,4987,11523,4.1,8.6,53,23.4
2623,2022-03-27,3212,5835,-1.7,4.1,3,25.4
1371,2022-03-28,3634,5005,-5.7,0.5,3,30.1
2036,2022-03-29,4609,6645,-3.8,1.2,1,18.6
3017,2022-03-30,5599,8616,3.9,7.3,3,17.2
2573,2022-03-31,5416,7989,15.2,16.9,63,28.6
3529,2022-04-01,5538,9067,6.9,11.2,53,28.9
7788,2022-04-02,5879,13667,4.2,7.5,2,16.4
5426,2022-04-03,4874,10300,6.0,9.9,51,27.1
3481,2022-04-04,5224,8705,4.7,8.0,3,15.4
1450,2022-04-05,3858,5308,8.2,9.9,61,17.9
2517,2022-04-06,5538,8055,10.9,12.1,63,18.7
1162,2022-04-07,3324,4486,8.7,10.5,63,18.4
4452,2022-04-08,6224,10676,8.2,11.0,51,18.9
6200,2022-04-09,5353,11553,6.4,9.0,53,16.4
3880,2022-04-10,4224,8104,2.9,7.6,51,26.0
3880,2022-04-11,5584,9464,7.0,9.6,2,14.7
4913,2022-04-12,6736,11649,15.8,16.4,51,15.0
5316,2022-04-13,7133,12449,20.2,20.0,3,20.0
4382,2022-04-14,6121,10503,19.3,21.0,51,24.5
7063,2022-04-15,6264,13327,11.6,14.6,1,20.4
8601,2022-04-16,5633,14234,15.0,17.8,51,21.1
5607,2022-04-17,4279,9886,7.2,10.7,51,20.8
920,2022-04-18,2565,3485,3.0,6.7,61,21.2
2601,2022-04-19,5580,8181,2.3,7.3,55,27.7
4108,2022-04-20,6731,10839,6.3,9.2,0,13.7
4180,2022-04-21,6571,10751,10.2,12.9,3,17.5
5948,2022-04-22,6967,12915,15.7,16.8,3,14.5
8236,2022-04-23,6666,14902,14.8,16.2,3,14.9
7578,2022-04-24,6082,13660,19.1,18.8,0,17.7
3962,2022-04-25,6378,10340,16.1,16.7,3,16.7
2650,2022-04-26,5616,8266,17.0,16.8,53,12.9
3548,2022-04-27,6703,10251,6.8,11.2,3,24.5
3512,2022-04-28,6386,9898,4.0,8.4,1,20.4
5106,2022-04-29,6395,11501,7.5,10.7,1,15.1
7754,2022-04-30,6259,14013,10.3,12.7,1,14.2
4032,2022-05-01,4355,8387,12.4,13.6,61,12.9
4759,2022-05-02,6582,11341,19.3,18.9,3,8.9
4599,2022-05-03,7210,11809,16.6,17.2,3,18.8
3990,2022-05-04,6853,10843,18.9,18.3,61,10.5
4462,2022-05-05,6781,11243,16.2,16.9,51,13.8
1301,2022-05-06,2867,4168,14.2,14.8,63,20.3
881,2022-05-07,1958,2839,6.7,10.0,61,26.5
3023,2022-05-08,4101,7124,5.5,9.1,3,23.9
3868,2022-05-09,6429,10297,10.1,12.6,0,15.0
4589,2022-05-10,7373,11962,12.2,14.6,0,17.1
4577,2022-05-11,7323,11900,13.8,15.5,3,15.9
4584,2022-05-12,6810,11394,16.7,16.9,3,16.4
4729,2022-05-13,5665,10394,19.1,18.1,61,16.5
6446,2022-05-14,5826,12272,20.3,18.6,53,12.8
6453,2022-05-15,5700,12153,23.1,20.7,51,7.6
3212,2022-05-16,5295,8507,22.1,21.0,53,20.3
4980,2022-05-17,7748,12728,18.4,20.1,1,22.7
4884,2022-05-18,7258,12142,17.1,18.1,3,13.0
4962,2022-05-19,7004,11966,21.7,21.3,63,17.9
5709,2022-05-20,6745,12454,26.7,25.1,3,18.9
7096,2022-05-21,5932,13028,30.0,28.4,1,18.2
5159,2022-05-22,4589,9748,29.7,26.8,61,14.9
4473,2022-05-23,6096,10569,19.7,20.0,51,16.6
3062,2022-05-24,5816,8878,15.3,15.8,55,14.4
4633,2022-05-25,7415,12048,16.0,17.2,3,13.9
4665,2022-05-26,6814,11479,18.5,18.2,3,15.0
3459,2022-05-27,4891,8350,22.5,20.8,61,22.0
8423,2022-05-28,5947,14370,21.4,21.1,55,15.3
9419,2022-05-29,5681,15100,22.8,22.0,3,11.5
6987,2022-05-30,5450,12437,25.5,24.8,1,20.4
4205,2022-05-31,6686,10891,28.9,27.5,1,21.1
4397,2022-06-01,6973,11370,30.3,28.0,2,8.8
3125,2022-06-02,5377,8502,29.0,25.8,63,11.5
6113,2022-06-03,7371,13484,22.5,22.7,1,15.3
8670,2022-06-04,7237,15907,22.5,22.8,1,10.2
7331,2022-06-05,6595,13926,19.7,21.0,1,14.9
5268,2022-06-06,7140,12408,20.9,21.9,1,17.4
3578,2022-06-07,5949,9527,22.4,22.1,55,19.9
4504,2022-06-08,7178,11682,27.1,24.3,61,10.2
5649,2022-06-09,7981,13630,24.8,24.4,51,22.1
6880,2022-06-10,7881,14761,21.2,21.7,3,10.8
7102,2022-06-11,6220,13322,21.3,20.2,61,11.1
6915,2022-06-12,6275,13190,24.8,22.1,61,11.4
4530,2022-06-13,6902,11432,30.6,26.6,51,10.0
4970,2022-06-14,7824,12794,28.7,24.8,65,11.8
5440,2022-06-15,7987,13427,29.0,25.8,3,11.5
5302,2022-06-16,7491,12793,27.9,24.9,63,15.7
5960,2022-06-17,7052,13012,30.8,28.6,51,24.7
9539,2022-06-18,7218,16757,19.4,22.0,3,28.6
8967,2022-06-19,6222,15189,17.1,20.1,1,22.2
7117,2022-06-20,6674,13791,19.3,21.1,2,12.7
5475,2022-06-21,7416,12891,23.9,23.6,2,12.5
3903,2022-06-22,6237,10140,26.4,23.9,63,14.8
4191,2022-06-23,6264,10455,21.5,19.7,63,14.8
7220,2022-06-24,8029,15249,24.6,22.3,51,8.4
8837,2022-06-25,7158,15995,27.0,24.5,2,11.4
6652,2022-06-26,5924,12576,27.8,25.9,51,17.7
4709,2022-06-27,6484,11193,26.4,24.3,63,15.1
5887,2022-06-28,8018,13905,22.4,22.8,1,14.8
5572,2022-06-29,7914,13486,25.3,24.2,2,11.7
5309,2022-06-30,7553,12862,28.9,26.3,2,12.7
5643,2022-07-01,6866,12509,30.7,28.1,51,14.5
6892,2022-07-02,5651,12543,30.9,27.4,63,15.5
9053,2022-07-03,5580,14633,28.9,25.9,53,11.0
12839,2022-07-04,6692,19531,26.6,25.1,1,10.6
5154,2022-07-05,6477,11631,28.8,25.5,65,18.5
5120,2022-07-06,7082,12202,32.2,28.1,51,12.1
5357,2022-07-07,6983,12340,28.9,24.8,61,13.1
5904,2022-07-08,7050,12954,29.2,25.3,51,6.9
3605,2022-07-09,4157,7762,26.2,22.6,65,15.1
7766,2022-07-10,6588,14354,25.6,23.1,3,8.4
5626,2022-07-11,7256,12882,25.2,23.2,3,11.9
3941,2022-07-12,6265,10206,29.0,26.2,55,16.8
5893,2022-07-13,8190,14083,30.0,26.8,2,14.5
6024,2022-07-14,7775,13799,28.8,26.4,51,11.5
6516,2022-07-15,7371,13887,28.3,25.3,1,8.8
7478,2022-07-16,6240,13718,28.5,24.4,63,8.5
7026,2022-07-17,5984,13010,30.0,25.6,51,9.1
4603,2022-07-18,6645,11248,31.1,26.8,61,18.2
5448,2022-07-19,8107,13555,30.4,26.8,2,10.1
5554,2022-07-20,7974,13528,31.4,27.8,1,12.7
4959,2022-07-21,6912,11871,32.9,29.0,55,13.4
5683,2022-07-22,6944,12627,31.3,28.8,1,11.4
6842,2022-07-23,5865,12707,32.6,29.1,1,15.8
5852,2022-07-24,5176,11028,32.9,29.5,2,15.2
3923,2022-07-25,6017,9940,32.6,28.8,65,16.3
4848,2022-07-26,7315,12163,28.4,24.7,51,8.7
5416,2022-07-27,7794,13210,30.5,25.9,61,9.3
5323,2022-07-28,7142,12465,31.6,27.1,55,13.6
4986,2022-07-29,6150,11136,30.2,25.6,61,9.1
8787,2022-07-30,6645,15432,27.7,25.6,2,12.9
5680,2022-07-31,5049,10729,27.8,24.2,61,11.7
5298,2022-08-01,7047,12345,28.5,25.1,53,11.3
5156,2022-08-02,7833,12989,30.6,27.0,51,13.1
5439,2022-08-03,7683,13122,30.1,27.2,3,9.4
3948,2022-08-04,5902,9850,33.0,28.3,55,10.8
4198,2022-08-05,5240,9438,32.2,26.7,63,8.7
8078,2022-08-06,6608,14686,30.4,26.0,51,13.6
6506,2022-08-07,5394,11900,31.9,27.6,55,13.1
4572,2022-08-08,6311,10883,33.1,28.7,51,12.5
4797,2022-08-09,6839,11636,34.2,29.8,2,11.3
2887,2022-08-10,4884,7771,32.7,27.3,65,10.0
5523,2022-08-11,7521,13044,28.0,25.2,63,12.7
6175,2022-08-12,7178,13353,25.0,24.6,51,13.3
8231,2022-08-13,6629,14860,22.0,22.0,1,11.8
6427,2022-08-14,5292,11719,23.5,22.6,53,12.4
4538,2022-08-15,6320,10858,22.7,20.8,61,9.1
5634,2022-08-16,7835,13469,23.1,21.9,51,13.4
5225,2022-08-17,7597,12822,24.5,22.5,51,6.6
5784,2022-08-18,7783,13567,24.2,22.8,0,9.0
5614,2022-08-19,7125,12739,26.6,24.0,51,12.4
7529,2022-08-20,6689,14218,27.9,25.0,2,12.1
4815,2022-08-21,5022,9837,26.7,23.6,63,12.6
3920,2022-08-22,6218,10138,28.3,23.8,63,8.6
5094,2022-08-23,8042,13136,26.3,24.0,1,12.4
5002,2022-08-24,7989,12991,27.3,25.0,1,8.9
4760,2022-08-25,7647,12407,28.7,25.4,51,9.8
5445,2022-08-26,7310,12755,29.7,26.6,51,10.9
7359,2022-08-27,7010,14369,29.3,25.9,51,9.5
5956,2022-08-28,6256,12212,30.4,26.2,51,10.1
3932,2022-08-29,7338,11270,30.5,26.5,51,12.3
3213,2022-08-30,6795,10008,30.3,27.0,51,18.4
4678,2022-08-31,8587,13265,24.8,24.1,3,15.5
4632,2022-09-01,8146,12778,25.4,24.5,0,10.2
5459,2022-09-02,7177,12636,25.1,24.2,3,13.0
7476,2022-09-03,5807,13283,27.6,25.0,51,11.0
7832,2022-09-04,5449,13281,28.4,25.6,51,11.3
5094,2022-09-05,5120,10214,27.5,24.7,55,11.2
3512,2022-09-06,6579,10091,27.4,24.1,65,17.4
3512,2022-09-07,7316,10828,24.1,21.5,61,10.7
4995,2022-09-08,8661,13656,23.9,22.0,51,10.9
5768,2022-09-09,8306,14074,23.2,21.8,2,10.9
8059,2022-09-10,7592,15651,23.2,21.4,3,9.1
3697,2022-09-11,5056,8753,26.3,22.5,61,12.0
3271,2022-09-12,6488,9759,27.9,23.5,63,6.6
4870,2022-09-13,9237,14107,22.9,22.1,51,16.1
5125,2022-09-14,9490,14615,20.4,20.6,2,13.5
5000,2022-09-15,9083,14083,21.7,21.1,1,12.7
5857,2022-09-16,8512,14369,20.5,19.7,0,6.3
8395,2022-09-17,7838,16233,23.1,21.5,3,10.4
6946,2022-09-18,7116,14062,23.2,22.0,2,10.2
4282,2022-09-19,7997,12279,25.2,23.4,2,15.3
5211,2022-09-20,8988,14199,24.3,23.3,0,13.5
4907,2022-09-21,9111,14018,23.5,22.7,1,12.2
4188,2022-09-22,8272,12460,21.2,22.1,53,26.0
5294,2022-09-23,8228,13522,12.4,16.0,2,19.4
7397,2022-09-24,7384,14781,14.2,15.8,1,11.4
5095,2022-09-25,6122,11217,19.5,19.8,51,14.7
4405,2022-09-26,8127,12532,18.7,19.8,2,17.5
4320,2022-09-27,8816,13136,14.9,17.7,3,18.4
4484,2022-09-28,8995,13479,13.1,15.3,3,14.6
4472,2022-09-29,8686,13158,13.4,15.8,1,17.9
3035,2022-09-30,5796,8831,11.8,14.3,63,22.5
2566,2022-10-01,4161,6727,13.4,15.1,65,26.8
1161,2022-10-02,2570,3731,11.9,13.5,61,21.2
1433,2022-10-03,4114,5547,6.7,9.8,61,19.2
1909,2022-10-04,5623,7532,7.2,10.2,61,19.1
2911,2022-10-05,6827,9738,11.4,13.1,61,18.0
4816,2022-10-06,8519,13335,16.2,16.8,0,10.2
5525,2022-10-07,7735,13260,16.9,17.8,51,17.9
6081,2022-10-08,6164,12245,9.4,12.4,51,14.7
5920,2022-10-09,6065,11985,8.2,10.8,0,12.2
4565,2022-10-10,6712,11277,10.2,12.2,0,8.9
3850,2022-10-11,8029,11879,12.7,14.1,0,10.2
4318,2022-10-12,8410,12728,13.8,15.0,3,15.3
2228,2022-10-13,5167,7395,17.6,17.6,63,16.9
4975,2022-10-14,7895,12870,14.1,15.2,3,12.7
7451,2022-10-15,6945,14396,13.5,15.3,0,17.2
5845,2022-10-16,6146,11991,13.8,15.2,51,12.6
3535,2022-10-17,7193,10728,14.9,15.9,53,17.1
3102,2022-10-18,7246,10348,5.6,9.7,2,15.6
3279,2022-10-19,7453,10732,4.3,8.0,3,18.8
3842,2022-10-20,7655,11497,5.4,8.8,0,16.4
4758,2022-10-21,7230,11988,8.7,11.0,0,10.0
7491,2022-10-22,6878,14369,10.8,12.3,1,9.0
4450,2022-10-23,4952,9402,11.2,12.7,61,13.0
3302,2022-10-24,6648,9950,14.2,14.4,51,10.6
3442,2022-10-25,7746,11188,17.2,16.3,51,7.7
3646,2022-10-26,7961,11607,16.4,16.3,51,16.1
4101,2022-10-27,8013,12114,11.0,14.0,3,17.7
4141,2022-10-28,7052,11193,8.4,11.3,2,13.5
6200,2022-10-29,6527,12727,9.6,11.8,3,10.5
5633,2022-10-30,5951,11584,9.1,10.7,2,7.5
1936,2022-10-31,5310,7246,13.5,13.8,63,12.0
3356,2022-11-01,7868,11224,16.4,16.6,61,15.2
3563,2022-11-02,8136,11699,14.4,15.2,2,13.6
4058,2022-11-03,8196,12254,13.2,14.0,1,9.2
4851,2022-11-04,7578,12429,15.9,15.8,3,11.8
7840,2022-11-05,7393,15233,19.6,19.4,2,17.9
5138,2022-11-06,5765,10903,21.0,20.0,61,18.9
3904,2022-11-07,7639,11543,19.6,19.9,1,13.8
3477,2022-11-08,7644,11121,8.1,12.0,1,16.3
3284,2022-11-09,7717,11001,6.8,9.6,1,12.2
4004,2022-11-10,7995,11999,12.3,13.0,3,8.4
2005,2022-11-11,3823,5828,18.4,17.8,61,22.4
7396,2022-11-12,6775,14171,18.0,18.5,53,23.9
3090,2022-11-13,4444,7534,3.4,8.4,51,22.7
2122,2022-11-14,5899,8021,1.9,5.4,1,13.0
1028,2022-11-15,3751,4779,1.4,4.6,63,16.1
2098,2022-11-16,6175,8273,2.8,6.6,61,18.7
1920,2022-11-17,5924,7844,-1.1,4.0,3,23.4
2168,2022-11-18,5552,7720,-1.7,2.6,51,17.7
2811,2022-11-19,4731,7542,-1.1,2.8,1,13.2
1663,2022-11-20,2982,4645,-4.8,0.5,0,22.5
1778,2022-11-21,4744,6522,-2.6,1.8,0,14.5
2230,2022-11-22,5052,7282,0.9,4.6,0,11.6
2732,2022-11-23,4613,7345,2.7,5.9,0,10.1
2302,2022-11-24,2195,4497,3.6,6.5,1,12.4
2241,2022-11-25,2718,4959,5.7,8.8,51,23.2
3727,2022-11-26,3804,7531,4.2,7.6,1,13.1
991,2022-11-27,2175,3166,7.6,10.0,63,17.8
2003,2022-11-28,5664,7667,7.2,10.2,3,21.6
2149,2022-11-29,6507,8656,4.1,7.0,3,13.2
1457,2022-11-30,4872,6329,5.7,9.4,63,27.1
2025,2022-12-01,6106,8131,-1.4,3.5,1,19.0
2459,2022-12-02,5960,8419,-0.4,3.4,2,12.8
3051,2022-12-03,4943,7994,7.8,10.9,61,26.9
2529,2022-12-04,4631,7160,0.6,4.4,1,15.6
1722,2022-12-05,5451,7173,-0.5,2.9,1,10.9
1302,2022-12-06,4297,5599,3.4,5.5,61,11.3
2159,2022-12-07,5916,8075,11.3,11.9,51,11.3
2572,2022-12-08,6673,9245,8.9,10.6,3,12.1
2557,2022-12-09,5987,8544,2.7,6.0,2,10.1
2660,2022-12-10,4753,7413,-0.6,2.8,3,9.2
2298,2022-12-11,4359,6657,3.6,6.0,51,10.5
1615,2022-12-12,4933,6548,0.2,4.0,3,16.0
1925,2022-12-13,5441,7366,-2.5,1.4,1,9.7
2029,2022-12-14,5621,7650,-3.5,0.2,3,8.0
430,2022-12-15,1672,2102,0.8,4.2,63,22.1
2282,2022-12-16,5243,7525,3.0,6.7,61,19.4
2415,2022-12-17,4451,6866,-1.2,2.8,3,16.2
1683,2022-12-18,3306,4989,-3.0,1.6,3,20.8
1233,2022-12-19,3945,5178,-3.9,0.9,1,16.6
1525,2022-12-20,4201,5726,-3.9,0.2,0,11.2
1561,2022-12-21,3907,5468,-3.4,0.1,1,9.6
333,2022-12-22,1271,1604,0.9,4.4,63,23.2
446,2022-12-23,1269,1715,-5.7,0.1,63,33.3
315,2022-12-24,796,1111,-15.2,-9.1,1,24.9
373,2022-12-25,570,943,-9.8,-5.1,0,13.0
609,2022-12-26,1240,1849,-8.2,-3.8,3,8.0
1221,2022-12-27,2292,3513,-4.0,-0.3,2,8.4
1872,2022-12-28,2713,4585,-3.1,0.9,1,11.2
2475,2022-12-29,3151,5626,-0.2,3.1,1,11.4
3056,2022-12-30,3765,6821,3.7,6.4,1,13.0
1481,2022-12-31,2157,3638,9.3,10.5,63,12.0
3573,2023-01-01,3214,6787,8.4,10.5,1,14.7
3433,2023-01-02,3807,7240,9.1,10.7,2,11.3
2635,2023-01-03,4924,7559,13.1,14.2,53,20.3
2488,2023-01-04,5303,7791,15.8,16.0,55,21.0
2954,2023-01-05,5455,8409,11.4,12.6,51,13.0
2119,2023-01-06,4600,6719,3.3,6.8,51,20.3
2862,2023-01-07,4260,7122,-0.3,3.7,3,14.8
1818,2023-01-08,3358,5176,-1.1,2.4,53,11.8
1754,2023-01-09,4766,6520,0.1,4.0,71,16.7
1863,2023-01-10,5440,7303,-0.8,2.7,2,14.0
1832,2023-01-11,5323,7155,-0.1,3.1,55,11.0
1746,2023-01-12,4909,6655,5.6,7.9,53,15.5
1925,2023-01-13,4565,6490,4.9,8.9,63,23.9
1502,2023-01-14,3368,4870,-3.5,2.3,3,24.6
1949,2023-01-15,3359,5308,-3.9,1.6,1,22.7
2291,2023-01-16,4130,6421,-1.7,2.9,1,13.9
1295,2023-01-17,4622,5917,2.0,4.7,55,10.2
2057,2023-01-18,6129,8186,4.8,7.9,51,17.4
1320,2023-01-19,4536,5856,4.7,6.8,61,12.6
2072,2023-01-20,5322,7394,2.9,7.2,3,24.0
2339,2023-01-21,4622,6961,-0.1,4.0,3,16.0
1289,2023-01-22,2712,4001,-0.8,2.6,61,13.0
1219,2023-01-23,4503,5722,0.5,4.7,53,24.5
1801,2023-01-24,5964,7765,-0.6,3.2,2,13.0
847,2023-01-25,3579,4426,0.6,4.0,71,20.3
1790,2023-01-26,5756,7546,1.6,6.1,61,26.0
1753,2023-01-27,5061,6814,-2.1,2.2,3,15.4
3611,2023-01-28,5101,8712,1.3,5.4,2,14.8
1513,2023-01-29,3257,4770,2.3,5.7,53,15.3
1971,2023-01-30,5715,7686,6.1,7.9,3,9.4
941,2023-01-31,3855,4796,2.3,5.0,53,13.7
1477,2023-02-01,5409,6886,-2.1,1.8,73,13.1
1477,2023-02-02,5312,6789,-1.8,2.0,3,11.4
965,2023-02-03,3695,4660,-7.1,-0.7,3,29.1
1177,2023-02-04,2838,4015,-9.6,-4.1,1,22.4
2244,2023-02-05,4168,6412,-1.2,3.7,3,16.7
1484,2023-02-06,5227,6711,2.5,6.6,3,21.4
1732,2023-02-07,5959,7691,0.7,4.1,3,14.1
2551,2023-02-08,7043,9594,7.3,9.9,2,14.0
2505,2023-02-09,6799,9304,8.9,11.5,3,21.2
2944,2023-02-10,6265,9209,9.4,12.8,1,21.3
3264,2023-02-11,5007,8271,1.9,5.9,1,19.5
656,2023-02-12,1713,2369,0.1,3.6,61,19.7
1910,2023-02-13,5758,7668,2.9,7.4,61,19.1
2444,2023-02-14,6774,9218,3.9,7.3,2,12.5
2480,2023-02-15,6848,9328,8.7,12.4,53,20.8
1674,2023-02-16,5265,6939,12.0,12.7,61,15.5
1379,2023-02-17,3647,5026,8.3,11.6,63,26.6
2871,2023-02-18,4135,7006,-2.2,2.5,1,21.1
4266,2023-02-19,4452,8718,3.3,7.4,3,20.3
2921,2023-02-20,4729,7650,8.4,11.1,2,17.8
2542,2023-02-21,6232,8774,8.3,10.9,53,25.1
1966,2023-02-22,5934,7900,4.1,7.4,51,13.1
4019,2023-02-23,7608,11627,16.4,16.8,51,17.3
2669,2023-02-24,5599,8268,6.6,11.0,1,22.2
1542,2023-02-25,3514,5056,-0.8,2.7,71,12.6
3186,2023-02-26,4742,7928,3.7,6.9,3,14.8
1274,2023-02-27,4430,5704,1.8,5.4,61,16.8
2328,2023-02-28,6542,8870,6.2,8.4,61,15.4
2472,2023-03-01,6738,9210,5.2,8.0,2,17.8
2443,2023-03-02,6753,9196,10.7,12.6,61,16.5
940,2023-03-03,3437,4377,3.1,6.7,61,23.3
3874,2023-03-04,5390,9264,6.6,10.6,61,28.5
4733,2023-03-05,5721,10454,5.7,9.0,1,22.0
2649,2023-03-06,6004,8653,4.9,7.7,1,11.3
2139,2023-03-07,6104,8243,1.9,6.7,51,27.3
2274,2023-03-08,6432,8706,0.1,5.2,0,23.5
2948,2023-03-09,6528,9476,2.4,6.0,0,13.6
1302,2023-03-10,3754,5056,2.4,5.4,55,14.4
2877,2023-03-11,4509,7386,-0.5,4.8,3,28.3
1911,2023-03-12,3199,5110,-0.6,2.6,71,8.0
1827,2023-03-13,4870,6697,2.5,5.3,51,16.1
1509,2023-03-14,4847,6356,-3.9,2.9,3,34.5
1832,2023-03-15,5264,7096,-2.4,3.9,0,27.6
3811,2023-03-16,6573,10384,3.5,7.6,3,14.4
3338,2023-03-17,5764,9102,8.4,11.5,51,18.9
6043,2023-03-18,5965,12008,2.9,7.6,3,21.0
2214,2023-03-19,3683,5897,-3.5,2.1,1,22.0
2688,2023-03-20,5874,8562,-0.4,3.3,0,9.9
3764,2023-03-21,7493,11257,3.7,7.0,2,12.5
4485,2023-03-22,8310,12795,7.5,11.0,3,15.9
5607,2023-03-23,8781,14388,14.0,15.5,53,20.6
1556,2023-03-24,3738,5294,10.4,11.6,63,11.2
3163,2023-03-25,4374,7537,8.6,10.2,61,14.0
11020,2023-03-26,7650,18670,9.7,12.6,0,16.6
3780,2023-03-27,6799,10579,9.9,11.3,53,12.8
4262,2023-03-28,8040,12302,6.8,10.0,3,15.3
4431,2023-03-29,8324,12755,6.2,9.1,3,13.6
4022,2023-03-30,7662,11684,3.1,6.8,0,18.2
4759,2023-03-31,7177,11936,7.7,10.7,53,22.2
5830,2023-04-01,5550,11380,15.0,17.8,61,32.4
6519,2023-04-02,6397,12916,4.7,8.9,1,25.0
5103,2023-04-03,7631,12734,9.4,11.9,2,19.0
6335,2023-04-04,8969,15304,17.2,17.8,1,14.0
6247,2023-04-05,8866,15113,21.8,21.4,2,20.1
4688,2023-04-06,7755,12443,22.8,21.9,63,17.1
4703,2023-04-07,6677,11380,8.5,11.9,51,14.5
6457,2023-04-08,6505,12962,5.0,8.8,1,14.5
6062,2023-04-09,5848,11910,6.8,9.3,1,10.4
4541,2023-04-10,7622,12163,7.9,10.3,0,12.1
5111,2023-04-11,9216,14327,11.7,14.1,1,13.3
5623,2023-04-12,9635,15258,16.8,19.2,3,17.3
5982,2023-04-13,9629,15611,19.5,20.8,0,12.2
6272,2023-04-14,8565,14837,19.2,19.9,3,14.4
8082,2023-04-15,7203,15285,21.2,19.3,61,10.2
7669,2023-04-16,7137,14806,21.2,20.8,3,14.9
4117,2023-04-17,7466,11583,13.6,16.6,51,22.2
4810,2023-04-18,8927,13737,10.6,14.4,1,23.8
5200,2023-04-19,9038,14238,12.4,14.5,0,12.3
5671,2023-04-20,9276,14947,18.8,18.7,1,11.3
6834,2023-04-21,8589,15423,21.6,22.3,1,15.8
4704,2023-04-22,5459,10163,16.9,18.4,63,22.6
6581,2023-04-23,7110,13691,10.9,13.6,51,18.0
4107,2023-04-24,7915,12022,7.2,10.7,2,14.6
4316,2023-04-25,9158,13474,7.4,10.3,3,10.7
4248,2023-04-26,8987,13235,11.2,12.7,53,13.8
5032,2023-04-27,8947,13979,13.8,14.7,51,14.8
705,2023-04-28,2122,2827,10.5,12.6,63,25.8
7853,2023-04-29,7812,15665,14.6,14.9,51,14.5
2228,2023-04-30,3602,5830,14.7,15.2,63,26.3
3624,2023-05-01,8064,11688,8.7,12.6,55,24.7
3133,2023-05-02,7690,10823,7.6,10.8,53,18.3
3440,2023-05-03,8080,11520,7.0,9.8,55,21.0
4246,2023-05-04,8787,13033,8.4,10.9,51,14.7
5591,2023-05-05,8796,14387,11.2,12.9,51,8.7
8502,2023-05-06,8230,16732,14.2,14.9,1,10.4
5569,2023-05-07,6382,11951,17.4,17.1,55,9.5
4714,2023-05-08,8150,12864,20.8,20.2,51,15.3
3954,2023-05-09,8575,12529,16.0,16.5,51,10.0
5578,2023-05-10,9931,15509,14.8,15.7,0,10.5
5624,2023-05-11,9811,15435,18.7,18.5,1,8.8
6427,2023-05-12,9136,15563,23.1,21.4,1,8.2
4594,2023-05-13,5807,10401,21.2,19.6,63,10.9
7681,2023-05-14,7430,15111,17.8,18.7,1,12.6
5119,2023-05-15,8427,13546,16.0,17.6,2,13.4
4530,2023-05-16,9018,13548,19.4,19.4,51,15.0
5499,2023-05-17,9679,15178,16.7,18.3,51,16.4
5548,2023-05-18,9437,14985,13.2,15.3,3,13.0
6922,2023-05-19,9241,16163,16.2,17.3,51,17.3
7822,2023-05-20,7394,15216,20.2,19.4,53,14.3
7814,2023-05-21,7157,14971,18.3,19.3,51,16.3
5467,2023-05-22,8309,13776,19.4,20.0,2,12.8
5587,2023-05-23,9505,15092,18.2,18.7,2,13.7
5429,2023-05-24,9758,15187,19.3,19.5,1,9.9
5642,2023-05-25,9144,14786,15.6,17.6,1,19.4
6747,2023-05-26,8319,15066,16.8,17.7,1,10.1
8764,2023-05-27,7165,15929,16.7,18.2,1,13.5
7856,2023-05-28,5968,13824,17.0,17.9,53,13.8
3687,2023-05-29,4106,7793,20.7,19.5,61,13.3
4717,2023-05-30,9134,13851,18.2,18.8,51,15.0
5281,2023-05-31,10214,15495,17.8,18.5,1,10.2
5428,2023-06-01,10079,15507,21.5,21.1,3,8.7
6059,2023-06-02,9072,15131,25.4,24.7,1,10.4
8196,2023-06-03,8566,16762,23.8,23.5,53,17.5
7085,2023-06-04,7969,15054,17.6,18.6,51,13.4
5006,2023-06-05,8639,13645,19.5,20.4,3,14.4
5349,2023-06-06,9940,15289,19.5,21.8,2,21.3
4847,2023-06-07,9344,14191,20.3,21.6,1,13.9
3942,2023-06-08,7634,11576,19.3,20.7,1,11.9
5662,2023-06-09,8815,14477,18.2,19.5,53,17.1
8933,2023-06-10,8735,17668,21.2,22.3,2,13.4
7462,2023-06-11,7937,15399,24.5,24.9,3,15.7
3803,2023-06-12,7608,11411,23.4,22.7,63,16.7
5469,2023-06-13,10277,15746,19.7,20.9,3,14.0
5778,2023-06-14,10363,16141,19.0,20.9,51,23.2
5962,2023-06-15,10657,16619,21.3,21.7,1,10.5
5849,2023-06-16,8860,14709,23.8,22.6,61,13.5
8689,2023-06-17,8217,16906,20.8,22.1,2,19.7
7691,2023-06-18,7496,15187,22.8,23.4,0,12.4
6483,2023-06-19,7859,14342,25.8,24.5,51,14.0
5564,2023-06-20,9932,15496,23.9,22.9,51,19.5
1840,2023-06-21,4849,6689,17.9,18.5,55,24.2
3825,2023-06-22,8446,12271,17.9,18.1,53,17.9
3112,2023-06-23,6279,9391,24.6,21.5,63,14.9
8149,2023-06-24,8664,16813,27.6,23.7,63,7.6
7551,2023-06-25,8131,15682,28.0,25.2,2,10.1
4602,2023-06-26,8373,12975,28.8,25.3,63,10.7
4305,2023-06-27,8542,12847,26.9,23.7,63,14.4
5691,2023-06-28,10150,15841,23.6,22.8,3,16.0
5009,2023-06-29,8807,13816,25.2,23.6,1,9.2
4988,2023-06-30,8101,13089,26.5,23.6,65,10.6
6335,2023-07-01,6702,13037,24.3,26.9,0,18.2
6676,2023-07-02,6752,13428,26.6,29.2,1,11.5
6649,2023-07-03,7430,14079,27.7,31.1,3,35.8
11550,2023-07-04,8380,19930,26.2,29.9,3,24.2
5341,2023-07-05,8408,13749,25.1,28.9,3,29.6
5469,2023-07-06,8972,14441,25.6,28.3,51,24.7
5823,2023-07-07,8804,14627,23.4,25.3,1,26.2
7813,2023-07-08,8378,16191,24.4,27.5,3,17.1
6214,2023-07-09,7402,13616,25.0,28.2,2,16.5
5376,2023-07-10,9302,14678,25.8,28.8,3,19.5
5657,2023-07-11,10199,15856,24.9,27.9,2,21.3
5498,2023-07-12,10026,15524,26.4,29.2,0,21.7
5685,2023-07-13,9452,15137,27.3,30.0,0,16.9
5196,2023-07-14,8144,13340,28.5,31.2,0,13.8
8031,2023-07-15,8035,16066,28.5,32.1,1,24.8
6086,2023-07-16,7005,13091,29.9,34.2,3,33.2
5406,2023-07-17,8650,14056,29.5,32.8,2,27.1
5755,2023-07-18,10278,16033,32.0,34.3,2,26.0
5708,2023-07-19,9821,15529,30.5,34.6,2,30.8
6335,2023-07-20,10284,16619,31.2,34.7,3,23.7
7202,2023-07-21,9629,16831,30.0,32.8,3,19.4
9624,2023-07-22,8742,18366,29.6,32.4,2,30.0
7837,2023-07-23,7961,15798,28.5,31.1,51,39.3
5269,2023-07-24,9082,14351,29.0,30.3,51,16.8
5093,2023-07-25,9499,14592,28.4,29.1,0,18.4
5737,2023-07-26,10192,15929,29.6,30.9,1,21.0
5239,2023-07-27,9270,14509,30.0,32.1,3,20.6
5001,2023-07-28,8106,13107,27.3,29.5,51,35.4
6667,2023-07-29,7301,13968,23.4,24.2,3,17.4
7358,2023-07-30,8124,15482,27.5,28.7,2,27.1
5290,2023-07-31,9172,14462,27.7,28.7,1,18.1
5731,2023-08-01,10572,16303,28.8,30.7,0,13.4
5823,2023-08-02,10580,16403,27.5,30.1,3,32.8
4594,2023-08-03,8712,13306,27.4,29.2,0,15.8
6363,2023-08-04,9240,15603,28.9,30.8,2,14.0
8541,2023-08-05,8704,17245,29.6,32.0,2,23.5
6040,2023-08-06,6881,12921,26.4,28.2,3,26.0
3545,2023-08-07,6710,10255,25.0,25.6,3,18.3
5881,2023-08-08,10427,16308,26.4,28.9,0,15.8
5460,2023-08-09,9880,15340,28.4,30.4,0,13.5
4844,2023-08-10,8925,13769,29.0,31.4,3,25.7
6604,2023-08-11,9352,15956,26.7,28.3,2,22.7
7733,2023-08-12,8307,16040,26.6,30.3,2,29.0
6674,2023-08-13,7513,14187,25.5,30.3,2,29.0
3978,2023-08-14,7328,11306,23.5,28.9,3,27.7
4906,2023-08-15,9094,14000,22.8,26.6,0,30.9
6034,2023-08-16,10223,16257,23.3,24.9,2,11.5
5814,2023-08-17,9923,15737,22.3,24.3,2,20.2
6520,2023-08-18,9412,15932,24.4,26.3,1,13.6
8835,2023-08-19,8947,17782,27.2,29.1,2,19.2
6917,2023-08-20,7998,14915,26.1,29.1,2,23.6
5020,2023-08-21,8892,13912,27.0,30.2,3,16.1
5548,2023-08-22,10525,16073,27.9,30.8,3,22.5
5594,2023-08-23,10815,16409,24.3,26.4,3,23.4
5430,2023-08-24,10096,15526,21.0,22.7,51,26.8
4813,2023-08-25,8989,13802,21.3,23.2,51,25.0
7845,2023-08-26,9055,16900,18.1,21.2,51,38.5
6936,2023-08-27,8594,15530,21.5,23.8,2,26.8
4247,2023-08-28,8987,13234,20.2,22.4,51,35.7
4778,2023-08-29,10488,15266,21.0,23.2,0,18.9
5608,2023-08-30,11233,16841,23.3,24.7,0,12.3
5882,2023-08-31,11192,17074,25.5,27.2,1,18.0
6607,2023-09-01,9731,16338,25.9,28.6,0,19.2
8613,2023-09-02,8477,17090,24.6,27.7,1,18.5
7758,2023-09-03,7462,15220,24.0,26.8,1,18.7
5670,2023-09-04,7535,13205,20.9,24.4,51,31.2
4190,2023-09-05,10273,14463,21.2,24.6,0,20.7
4812,2023-09-06,10745,15557,22.1,25.1,2,20.2
4849,2023-09-07,10860,15709,22.4,25.6,1,19.6
5246,2023-09-08,10196,15442,22.5,25.9,2,19.1
5515,2023-09-09,7628,13143,23.8,26.8,1,16.9
5177,2023-09-10,8023,13200,24.4,26.8,1,8.7
4574,2023-09-11,10037,14611,24.0,26.4,0,13.5
4816,2023-09-12,11313,16129,24.1,27.4,0,29.8
5564,2023-09-13,11805,17369,22.7,27.0,0,33.0
5813,2023-09-14,11736,17549,21.9,25.2,0,13.2
5955,2023-09-15,10960,16915,22.9,26.3,0,23.2
8722,2023-09-16,9880,18602,22.5,25.4,2,16.1
4972,2023-09-17,7036,12008,22.2,24.8,51,18.4
4721,2023-09-18,9842,14563,20.4,23.4,3,16.8
5086,2023-09-19,11074,16160,19.6,22.5,1,15.5
4924,2023-09-20,11438,16362,19.3,22.6,53,26.2
5418,2023-09-21,11245,16663,18.8,21.6,3,23.8
5666,2023-09-22,10404,16070,12.9,16.4,61,29.5
1145,2023-09-23,2822,3967,12.7,14.8,1,20.3
3098,2023-09-24,6087,9185,13.4,15.3,1,15.2
3545,2023-09-25,9079,12624,13.4,15.4,3,13.5
3336,2023-09-26,9226,12562,14.0,16.2,1,10.7
5226,2023-09-27,11903,17129,15.2,17.9,3,14.7
5507,2023-09-28,11410,16917,15.8,18.7,51,20.4
6027,2023-09-29,10603,16630,14.4,18.3,3,31.0
8444,2023-09-30,10264,18708,13.4,16.4,51,26.3
7762,2023-10-01,9815,17577,15.1,17.2,3,12.6
5017,2023-10-02,10665,15682,14.5,17.9,2,22.4
5298,2023-10-03,11720,17018,14.7,18.0,1,13.0
5207,2023-10-04,12055,17262,15.3,18.0,1,13.7
5412,2023-10-05,11396,16808,15.8,18.8,2,11.9
5984,2023-10-06,10426,16410,16.0,19.7,3,19.9
6276,2023-10-07,8253,14529,14.9,18.0,1,14.1
6339,2023-10-08,7694,14033,15.4,18.2,3,14.6
4507,2023-10-09,8384,12891,13.9,17.4,3,26.0
4637,2023-10-10,11073,15710,13.4,16.0,3,19.5
5093,2023-10-11,11609,16702,14.1,17.0,1,17.1
5942,2023-10-12,11395,17337,13.9,16.8,1,11.4
6800,2023-10-13,10745,17545,13.5,17.5,1,26.1
2947,2023-10-14,5183,8130,12.1,16.0,0,14.0
5686,2023-10-15,8068,13754,12.7,16.2,3,15.7
4216,2023-10-16,9666,13882,12.1,16.0,3,16.6
4669,2023-10-17,10975,15644,10.7,15.0,3,20.8
4945,2023-10-18,11468,16413,8.7,13.2,3,19.5
5689,2023-10-19,11466,17155,8.8,13.3,2,18.5
4696,2023-10-20,8802,13498,8.0,12.1,1,15.3
8031,2023-10-21,9318,17349,9.2,12.9,1,15.6
6118,2023-10-22,8474,14592,8.6,12.4,2,12.3
4265,2023-10-23,10100,14365,11.1,14.8,3,16.2
5085,2023-10-24,11898,16983,10.0,13.6,0,13.9
5403,2023-10-25,12580,17983,8.9,12.4,1,11.8
5750,2023-10-26,12274,18024,9.3,12.9,2,11.3
6894,2023-10-27,11689,18583,11.0,14.7,1,15.0
9505,2023-10-28,10669,20174,10.6,13.9,2,11.5
7965,2023-10-29,9199,17164,9.6,12.9,1,10.8
4005,2023-10-30,9180,13185,10.4,13.8,1,13.5
4072,2023-10-31,10630,14702,11.0,16.5,2,40.1
3179,2023-11-01,9533,12712,9.2,14.8,3,28.1
3687,2023-11-02,9637,13324,5.7,10.3,2,22.2
4879,2023-11-03,9356,14235,5.2,9.0,0,10.5
8308,2023-11-04,10012,18320,5.1,9.3,0,16.9
6791,2023-11-05,8656,15447,4.0,7.1,1,6.6
4095,2023-11-06,9749,13844,4.6,7.9,1,10.9
4457,2023-11-07,11281,15738,4.0,7.5,1,11.4
4236,2023-11-08,11112,15348,4.9,8.3,1,8.9
4471,2023-11-09,10478,14949,3.6,7.7,51,12.3
2600,2023-11-10,5890,8490,0.6,4.7,3,22.8
6719,2023-11-11,8295,15014,0.8,4.7,1,14.5
4442,2023-11-12,6911,11353,0.9,4.5,0,10.3
3458,2023-11-13,9175,12633,0.8,5.0,1,12.9
4254,2023-11-14,10309,14563,-0.2,4.2,0,16.3
3912,2023-11-15,10572,14484,-1.4,2.4,0,9.2
4380,2023-11-16,10743,15123,-1.8,2.0,0,8.8
4866,2023-11-17,9954,14820,-1.0,2.8,1,7.1
5767,2023-11-18,8155,13922,0.5,4.4,3,9.2
4791,2023-11-19,7164,11955,0.6,4.6,1,10.3
2963,2023-11-20,7865,10828,0.5,5.0,0,15.7
825,2023-11-21,2861,3686,-1.0,3.2,0,10.7
3087,2023-11-22,6383,9470,-1.6,2.5,0,9.1
2792,2023-11-23,3343,6135,-1.4,3.3,2,17.4
3296,2023-11-24,4325,7621,-2.3,1.9,1,10.9
2922,2023-11-25,4537,7459,-2.0,1.8,1,9.8
1551,2023-11-26,3731,5282,-1.1,2.6,2,10.2
2122,2023-11-27,7575,9697,-2.5,1.3,1,9.2
1937,2023-11-28,7576,9513,-2.1,1.9,1,11.5
2161,2023-11-29,7920,10081,-3.2,1.0,2,9.5
3074,2023-11-30,9481,12555,-3.0,0.9,3,8.9
2261,2023-12-01,6570,8831,-3.3,0.6,2,11.0
4994,2023-12-02,8256,13250,-4.1,-0.3,1,8.2
2750,2023-12-03,6069,8819,-4.9,-0.8,1,9.7
2853,2023-12-04,8771,11624,-1.4,2.8,0,15.2
2969,2023-12-05,9247,12216,-2.8,1.5,0,12.8
2688,2023-12-06,8738,11426,-2.6,1.4,1,11.5
2739,2023-12-07,8488,11227,1.3,5.9,1,15.6
3708,2023-12-08,8764,12472,-2.5,1.3,3,9.8
5162,2023-12-09,8350,13512,-2.7,1.6,2,12.4
1326,2023-12-10,3230,4556,-4.7,0.1,3,19.4
2171,2023-12-11,7287,9458,-7.3,-3.2,1,11.5
2597,2023-12-12,8492,11089,-1.3,4.4,3,26.2
2927,2023-12-13,8455,11382,-6.8,-1.0,3,27.0
2907,2023-12-14,7884,10791,-11.9,-6.8,3,13.2
3552,2023-12-15,8231,11783,-12.5,-8.2,3,10.4
4696,2023-12-16,7576,12272,-12.9,-8.7,3,8.7
2044,2023-12-17,3976,6020,-11.5,-7.4,0,10.9
2381,2023-12-18,6703,9084,-11.3,-7.1,1,10.9
2218,2023-12-19,6791,9009,-11.7,-7.7,3,7.2
2377,2023-12-20,6919,9296,-10.6,-6.5,3,8.7
2317,2023-12-21,6206,8523,-10.7,-6.3,0,13.0
2393,2023-12-22,5197,7590,-10.9,-6.8,1,8.3
2150,2023-12-23,4101,6251,-10.2,-6.1,1,9.8
1518,2023-12-24,2933,4451,-9.2,-5.2,1,10.1
2072,2023-12-25,2263,4335,-8.9,-4.7,1,12.7
1090,2023-12-26,2607,3697,-8.9,-4.8,1,9.4
646,2023-12-27,1934,2580,-8.6,-4.3,71,10.1
3099,2023-12-28,4819,7918,-7.0,-2.5,0,12.8
3491,2023-12-29,5168,8659,-7.8,-3.9,1,9.5
3097,2023-12-30,4497,7594,-7.3,-2.9,1,13.8
2839,2023-12-31,4488,7327,-8.9,-4.6,0,10.2
